###########################
# ###    #  # # ##   # ## #
#    #     #   # # # #   ##
#     #    #   # # # # # ##
# #           #      1    #
#       #   # #      #    #
#  #           #  # #     #
#          #     # #   # ##
#      ###   #    # #   ###
#      ###      ## 2   #  #
#   # # ####    #         #
#     ##      #    # #    #
#      S#      # # #      #
##      # #   ##   #   ## #
###########################
