###########################
#  #  # ##     ##     # # #
#       # # 3             #
#     ## ## #   #### # #  #
#        # #    ##    #   #
#  ### ## ##  # #  ## #   #
## #          # ## #     ##
#  ## #   ##             ##
# 2 # ###        #   #    #
#        ## #  #     #  # #
## #     #   #    #  #    #
#     ##    #### #        #
##  # #  ###   # #        #
#  #1 #  #  #          S  #
###########################
