###########################
#      #   #     #        #
#  # ## # # #    ##    #  #
#  #  #   4      #    # # #
## # # #        #  #   ## #
# ##     #  ##      #   ###
# 3 #  #           #  #   #
#   #    #    ##         ##
##  # #   #    ##  # ##   #
## #         #   #   #    #
#          #   ## # #  S  #
#       #  #    ## #    # #
# #  ##        1   # #  # #
# 2 #          #          #
###########################
