###########################
# #  # #  ##   #    #     #
#    #   #  ## #       1  #
#  5# # #         #       #
#   ##  #  ### #   # # ####
# #      #   #  # ###  ####
##  ##    # #   # # #     #
#   # #      S  #       # #
#    # #  #   ###  ###  2 #
#     ##   #  #  # #      #
#   ###     #      #  # ###
# # ## #    ###   # # #   #
#  # 4##  #   #  #     ## #
#  #          #  3   #    #
###########################
